R  1920 1080
SO ./textures/walls/WOLF3D/redbrick.xpm
NO ./textures/walls/WOLF3D/eagle.xpm
WE ./textures/walls/WOLF3D/greystone.xpm
EA ./textures/walls/WOLF3D/mossy.xpm
S ./textures/sprites/death.xpm
F 100, 100, 100
C 170, 170, 210



111111111111111
100000111111111
11000000000E001
111111111111111




