R  1920 1080
SO ./textures/walls/WOLF3D/redbrick.xpm
NO ./textures/walls/WOLF3D/eagle.xpm
WE ./textures/walls/WOLF3D/greystone.xpm
EA ./textures/walls/WOLF3D/mossy.xpm
S ./textures/sprites/18.xpm
F 100, 100, 100
C 170, 170, 210



1111111111111111111111111
1000000000110000000000001
1111111110000000000000001
        1011000001110000111111111
        1001000000000000000000001
111111111011000001110000000000001
100000000011000001110111111111111
11110111111111011100000010001
11110111111111011101010000001
11000000110111011100000010001
11112000000011111110000001001
   100000001111  1101010012011111111111
11110001110101111111011110E000010001111
11110111 1110101 1011110102011111111111
11111111 1111111 111111111111




