1111
100000000000001
100000000000N01
111