111111
100000000000000000000001
101001
110000000000000N1
111111