
1111111
1010001
10100S1
1001001
1000101
1111111