111111
100N01
1N10W1
110S01
111111