1111111
1111111
1S11111
1111111
1111111
1111111