1111111
1000001
1S00001
1000001
1000011
1111111