11111111111111111111111111111
100000000000001111
1100000000000N1101
111111111111111111