111111
100101
101001
1100J1
111111