111111
100011
100001
1S0001
100001
100001
111111